Kvízkérdések

Alapmondatok kategória:
	- Jó reggelt - Bom dia!
	- Jó estét - Boa tarde / Boa noite!
	- Jó éjszakát - Boa noite!
	- Viszlát később! - Até mais tarde!
	- Viszlát holnap! - Até amanhã!
	- Hogy vagy? - Como vai?
	- Honnan jöttél? - De onde você é?
	- Hány éves vagy? - Quantos anos você tem?
	- Sajnálom. - Dasculpa.
	- Elnézést. - Com licença.
	- Elnézést (ha pl. összeütközünk valakivel) - Desculpe
	- Köszönöm szépen! - Muito obrigada / obrigado!
	- Szívesen! - De nada.
	- Örülök, hogy találkoztunk! - É um prazer!
	- Szép napot! - Tenha um bom dia!
	- Viszontlátásra! - Até logo!
	- Éhes vagyok. - Estou com fome.
	- Szomjas vagyok. - Estou com sede.
	- Fáradt vagyok. - Estou cansado.
	- Nem tudom. - Eu não sei.
	- Igen - Sim
	- Nem - Não
	- Kérlek - Por favor
	- Hogy mondja? - Como se diz?
	- Ismételje meg kérem! - Repita, por favor!
	- Mit mondtál? - O que você disse?
	- Nem értm. - Eu não entendi.
	
Ünnep kategória
	- Boldog születésnapot! - Feliz aniversário!
	- Sok szerencsét! - Boa sorte!
	- Boldog Új Évet! - Feliz Ano Novo!
	- Boldog Karácsonyt! - Feliz Natal!
	- Születésnapi képeslap - Cartão de aniversário
	- Gratulálok! - Parabéns!
	- Ajándék - Presente
	- Akarsz táncolni? - Você quer dançar?
	- Igen, szeretnék táncolni. - Sim, eu quero dançar.
	- Nem akarok táncolni. - Eu não quero dançar.
	- Hozzám jössz feleségül? - Você quer se casar comigo?
	
Érzelmek kategória
	- Boldog - Feliz
	- Szomorú - Triste
	- Mérges - Bravo
	- Félelem - Medo
	- Öröm - Alegria
	- Meglepett - Surpreso
	- Nyugalom - Calmo
	- Élő - Vivo
	- Halott - Morto
	- Egyedül - Sozinho
	- Együtt - Juntos
	- Unalom - Entediado
	- Künnyű - Fácil
	- Nehéz - Difícil
	- Rossz - Ruim
	- Jó - Bom
	- Sajnálom - Sinto muito
	- Ne aggódj! - Não se preocupe
	
Napok, hónapok kategória
	- A hét napjai - Os dias da semana
	- Hétfő - Segunda-feira
	- Kedd - Terça-feira
	- Szerda - Quarta-feira
	- Csütörtök - Quinta-feira
	- Péntek - Sexta-feira
	- Szombat - Sábado
	- Vasárnap - Domingo
	- Nap - Dia
	- Hét - Semana
	- Hétvége - Final de semana
	- Az év hónapjai - Os meses do ano
	- Január - Janeiro
	- Február - Fevereiro
	- Március - Março
	- Április - Abril
	- Május - Maio
	- Június - Junho
	- Július - Julho
	- Augusztus - Agosto
	- Szeptember - Setembro
	- Október - Outubro
	- November - Novembro
	- December - Dezembro
	- Hónap - Mês
	- Év - Ano
	
Színek kategória
	- Szín - Cor
	- Fekete - Preto
	- Fehér - Braco
	- Kék - Azul
	- Barna - Marrom
	- Zöld - Verde
	- Narancssárga - Alaranjado
	- Lila - Roxo
	- Piros - Vermelho
	- Sárga - Amarelo
	- Szürke - Cinza
	- Aranyszínű - Dourado
	- Ezüstszínű - Prateado
	- Milyen színű ez? - Qual é a cor?
	- Piros színű. - A cor é vermelha.
	
Földrajz és csillagászat kategória
	- Vulkán - (o) Vulcão
	- Erdő - (a) Floresta
	- Dzsungel - (a) Selva
	- Hegy - (a) Montanha
	- Hegyvonulat - (a) Serra
	- Domb - (a) Colina
	- Vízesés - (a) Cachoeira
	- Folyó - (o) Rio
	- Tó - (o) Lago
	- Sivatag - (o) Deserto
	- Félsziget - (a) Península
	- Sziget - (a) Ilha
	- Strand - (a) Praia
	- Óceán - (o) Oceano
	- Tenger - (o) Mar
	- Öböl - (a) Baía
	- Tengerpart - (a) Costa
	- Galaxis - Galáxia
	- Csillag - Estrela
	- Hold - Lua
	- Bolygó - Planeta
	- Aszteroida - Asteróide
	- Üstökös - Cometa
	- Meteor - Meteoro
	- Űr - Espaço
	- Világegyetem - Universo
	- Teleszkóp - Telescópio
	- Naprendszer - Sistema solar
	- Nap - Sol
	- Merkúr - Mercúrio
	- Vénusz - Vênus
	- Föld - Terra
	- Mars - Marte
	- Jupiter - Júpiter
	- Szaturnusz - Saturno
	- Uránusz - Urano
	- Neptunusz - Neptuno
	- Plútó - Plutão
	
Évszakok és időjárás kategória
	- Évszakok - Estaçoes
	- Tél - (o) Inverno
	- Nyár - (o) Verão
	- Tavasz - (a) Primavera
	- Ősz - (o) Outono
	- Ég - Céu
	- Felhő - Nuvem
	- Szivárvány - Arco-íris
	- Hideg (időjárás) - Frio
	- Meleg (időjárás) - Quente
	- Meleg van - Está quente
	- Hideg van - Está frio
	- Napos idő van - Está ensolarando
	- Felhős idő van - Está nublado
	- Nedves idő van - Está úmido
	- Esik az eső - Está chovendo
	- Havazik - Está nevando
	- Szeles idő van - Está ventando
	- Milyen az idő? - Como está o clima?
	- Jó idő - Tempo agradável
	- Rossz idő - Tempo feio
	- Hány fok van? - Qual é a temperatura?
	- 24 fok van. - Está fazento vinte e quatro graus.
	